GGGGGGGGGGGGGGGGGGGGGGGGGGGGGGGGGGGGGGGGGGGGGGGGGGGIAAAAAAAAAAWGGGGGGGGGGGGGG
GGGGGGGGGGGGGGGGGGGGGGGGGGGGGGGGGGGGGGGGGGGGGGGGGGGIAAAAAAAAAAWGGGGGGGGGGGGGG
GGGGGGGGGGGGGGGGGGGTTTTTTTTTTTTTTTTTTTTTTTTTTTTTTTTIAAAAAAAAAAWGGGGGGGGGGGGGG
GGGGGGGGGGGGGGGGGGTTTTTTTTTTTTTTTTTTTTTTTTTTTTTTTTTOAAAAAAAAAAWGGGGGGGGGGGGGG
GGGGGGGGGGGGGGGGGGTTPPPPPPPPPPPPPPPPPPPPPPPPPPPPPPPQAAAAAAAAAAWGGGGGGGGGGGGGG
GGGGGGGGGGGGGGGGGGTTPPPPPPPPPPPPPPPPPPPPPPPPPPPPPPPQAAAAAAAAAAWGGGGGGGGGGGGGG
GGGGGGGGGGGGGGGGGGTTPPPPPPPPPPPPPPPPPPPPPPPPPPPPPPPQAAAAAAAAAAWGGGGGGGGGGGGGG
GGGGGGGGGGGGGGGGGGTTPPPPPPPPPPPPPPPPPPPPPPPPPPPPPPPQAAAAAAAAAAWGGGGGGGGGGGGGG
GGGGGGGGGGGGGGGGGGTTPPPPPPPPPPPPPPPPPPPPPPPPPPPPPPPQAAAAAAAAAAWGGGGGGGGGGGGGG
GGGGGGGGGGGGGGGGGGTTPPPPPPPPPPPPPPPPPPPPPPPPPPPPPPPQAAAAAAAAAAWGGGGGGGGGGGGGG
GGGGGGGGGGGGGGGGGGTTPPPPPPPPPPPPPPPPPPPPPPPPPPPPPPPQAAAAAAAAAAWGGGGGGGGGGGGGG
GGGGGGGGGGGGGGGGGGTTPPPPPPPPPPPPPPPPPPPPPPPPPPPPPPPQAAAAAAAAAAWGGGGGGGGGGGGGG
TTTTTTTTTTTTTTTTTTTTPPPPPPPPPPPPPPPPPPPPPPPPPPPPPPPQAAAAAAAAAAWGGGGGGGGGGGGGG
TTTTTTTTTTTTTTTTTTTTPPPPPPPPPPPPPPPPPPPPPPPPPPPPPPPQAAAAAAAAAAWGGGGGGGGGGGGGG
RRRRRRRRRRRRRRRRRRRTPPPPPPPPPPPPPPPPPPPPPPPPPPPPPPPQAAAAAAAAAAWGGGGGGGGGGGGGG
RRRRRRRRRRRRRRRRRRRTPPPPPPPPPPPPPPPPPPPPPPPPPPPPPPPQAAAAAAAAAAWGGGGGGGGGGGGGG
TTTTTTTTTTTTTTTTTTTTPPPPPPPPPPPPPPPPPPPPPPPPPPPPPPPQAAAAAAAAAAWGGGGGGGGGGGGGG
TTTTTTTTTTTTTTTTTTTTPPPPPPPPPPPPPPPPPPPPPPPPPPPPPPPQAAAAAAAAAAWGGGGGGGGGGGGGG
GGGGGGGGGGGGGGGGGGTTPPPPPPPPPPPPPPPPPPPPPPPPPPPPPPPQAAAAAAAAAAWGGGGGGGGGGGGGG
GGGGGGGGGGGGGGGGGGTTPPPPPPPPPPPPPPPPPPPPPPPPPPPPPPPQAAAAAAAAAAWGGGGGGGGGGGGGG
GGGGGGGGGGGGGGGGGGTTPPPPPPPPPPPPPPPPPPPPPPPPPPPPPPPQAAAAAAAAAAWGGGGGGGGGGGGGG
GGGGGGGGGGGGGGGGGGTTPPPPPPPPPPPPPPPPPPPPPPPPPPPPPPPQAAAAAAAAAAWGGGGGGGGGGGGGG
GGGGGGGGGGGGGGGGGGTTPPPPPPPPPPPPPPPPPPPPPPPPPPPPPPPQAAAAAAAAAAWGGGGGGGGGGGGGG
GGGGGGGGGGGGGGGGGGTTPPPPPPPPPPPPPPPPPPPPPPPPPPPPPPPMNMNMNMNMNMNGGGGGGGGGGGGGG
GGGGGGGGGGGGGGGGGGTTPPPPPPPPPPPPPPPPPPPPPPPPPPPPPPPMNMNMNMNMNMNGGGGGGGGGGGGGG
GGGGGGGGGGGGGGGGGGTTPPPPPPPPPPPPPPPPPPPPPPPPPPPPPPPSYYYYYYYYYYUGGGGGGGGGGGGGG
GGGGGGGGGGGGGGGGGGTTPPPPPPPPPPPPPPPPPPPPPPPPPPPPPPPQAAAAAAAAAAWGGGGGGGGGGGGGG
GGGGGGGGGGGGGGGGGGTTPPPPPPPPPPPPPPPPPPPPPPPPPPPPPPPQAAAAAAAAAAWGGGGGGGGGGGGGG
GGGGGGGGGGGGGGGGGGTTPPPPPPPPPPPPPPPPPPPPPPPPPPPPPPPQAAAAAAAAAAWGGGGGGGGGGGGGG
GGGGGGGGGGGGGGGGGGTTPPPPPPPPPPPPPPPPPPPPPPPPPPPPPPPQAAAAAAAAAAWGGGGGGGGGGGGGG
GGGGGGGGGGGGGGGGGGTTPPPPPPPPPPPPPPPPPPPPPPPPPPPPPPPQAAAAAAAAAAWGGGGGGGGGGGGGG
GGGGGGGGGGGGGGGGGGTTPPPPPPPPPPPPPPPPPPPPPPPPPPPPPPPQAAAAAAAAAAWGGGGGGGGGGGGGG
GGGGGGGGGGGGGGGGGGTTTTTTTTTTTTTTTTTTTTTTTTTTTTTTTTTDAAAAAAAAAAWGGGGGGGGGGGGGG
GGGGGGGGGGGGGGGGGGGTTTTTTTTTTTTTTTTTTTTTTTTTTTTTTTTIAAAAAAAAAAWGGGGGGGGGGGGGG
GGGGGGGGGGGGGGGGGGGGGGGGGGGGGGGGGGGGGGGGGGGGGGGGGGGIAAAAAAAAAAWGGGGGGGGGGGGGG
GGGGGGGGGGGGGGGGGGGGGGGGGGGGGGGGGGGGGGGGGGGGGGGGGGGIAAAAAAAAAAWGGGGGGGGGGGGGG
GGGGGGGGGGGGGGGGGGGGGGGGGGGGGGGGGGGGGGGGGGGGGGGGGGGIAAAAAAAAAAWGGGGGGGGGGGGGG
GGGGGGGGGGGGGGGGGGGGGGGGGGGGGGGGGGGGGGGGGGGGGGGGGGGIAAAAAAAAAAKEEEEEEEEEEEEEE
GGGGGGGGGGGGGGGGGGGGGGGGGGGGGGGGGGGGGGGGGGGGGGGGGGGIAAAAAAAAAAAAAAAAAAAAAAAAA
GGGGGGGGGGGGGGGGGGGGGGGGGGGGGGGGGGGGGGGGGGGGGGGGGGGIAAAAAAAAAAAAAAAAAAAAAAAAA
GGGGGGGGGGGGGGGGGGGGGGGGGGGGGGGGGGGGGGGGGGGGGGGGGGGIAAAAAAAAAAAAAAAAAAAAAAAAA
GGGGGGGGGGGGGGGGGGGGGGGGGGGGGGGGGGGGGGGGGGGGGGGGGGGIAAAAAAAAAAAAAAAAAAAAAAAAA
GGGGGGGGGGGGGGGGGGGGGGGGGGGGGGGGGGGGGGGGGGGGGGGGGGGIAAAAAAAAAAAAAAAAAAAAAAAAA
