GGGGGGGGGGGGGGGGGGGGGGGGGGGGGGGGGGGGGGGGGGGGGGGGGGGIAAAAAAAAAAWGGGGGGGGGGGGGG
GGGGGGGGGGGGGGGGGGGGGGGGGGGGGGGGGGGGGGGGGGGGGGGGGGGIAAAAAAAAAAWGGGGGGGGGGGGGG
GGGGGGGGGGGGGGGGGGGFFFFFFFFFFFFFFFFFFFFFFFFFFFFFFFFIAAAAAAAAAAWGGGGGGGGGGGGGG
GGGGGGGGGGGGGGGGGGCJHHHHHHHHHHHHHHHHHHHHHHHHHHHHHHHOAAAAAAAAAAWGGGGGGGGGGGGGG
GGGGGGGGGGGGGGGGGGCXPPPPPPPPPPPPPPPPPPPPPPPPPPPPPPPQAAAAAAAAAAWGGGGGGGGGGGGGG
GGGGGGGGGGGGGGGGGGCXPPPPPPPPPPPPPPPPPPPPPPPPPPPPPPPQAAAAAAAAAAWGGGGGGGGGGGGGG
GGGGGGGGGGGGGGGGGGCXPPPPPPPPPPPPPPPPPPPPPPPPPPPPPPPQAAAAAAAAAAWGGGGGGGGGGGGGG
GGGGGGGGGGGGGGGGGGCXPPPPPPPPPPPPPPPPPPPPPPPPPPPPPPPQAAAAAAAAAAWGGGGGGGGGGGGGG
GGGGGGGGGGGGGGGGGGCXPPPPPPPPPPPPPPPPPPPPPPPPPPPPPPPQAAAAAAAAAAWGGGGGGGGGGGGGG
GGGGGGGGGGGGGGGGGGCXPPPPPPPPPPPPPPPPPPPPPPPPPPPPPPPQAAAAAAAAAAWGGGGGGGGGGGGGG
GGGGGGGGGGGGGGGGGGCXPPPPPPPPPPPPPPPPPPPPPPPPPPPPPPPQAAAAAAAAAAWGGGGGGGGGGGGGG
GGGGGGGGGGGGGGGGGGCXPPPPPPPPPPPPPPPPPPPPPPPPPPPPPPPQAAAAAAAAAAWGGGGGGGGGGGGGG
555555555555555555VXPPPPPPPPPPPPPPPPPPPPPPPPPPPPPPPQAAAAAAAAAAWGGGGGGGGGGGGGG
6666666666666666661PPPPPPPPPPPPPPPPPPPPPPPPPPPPPPPPQAAAAAAAAAAWGGGGGGGGGGGGGG
RRRRRRRRRRRRRRRRRR8PPPPPPPPPPPPPPPPPPPPPPPPPPPPPPPPQAAAAAAAAAAWGGGGGGGGGGGGGG
RRRRRRRRRRRRRRRRRR8PPPPPPPPPPPPPPPPPPPPPPPPPPPPPPPPQAAAAAAAAAAWGGGGGGGGGGGGGG
tttttttttttttttttt23PPPPPPPPPPPPPPPPPPPPPPPPPPPPPPPQAAAAAAAAAAWGGGGGGGGGGGGGG
777777777777777777BXPPPPPPPPPPPPPPPPPPPPPPPPPPPPPPPQAAAAAAAAAAWGGGGGGGGGGGGGG
GGGGGGGGGGGGGGGGGGCXPPPPPPPPPPPPPPPPPPPPPPPPPPPPPPPQAAAAAAAAAAWGGGGGGGGGGGGGG
GGGGGGGGGGGGGGGGGGCXPPPPPPPPPPPPPPPPPPPPPPPPPPPPPPPQAAAAAAAAAAWGGGGGGGGGGGGGG
GGGGGGGGGGGGGGGGGGCXPPPPPPPPPPPPPPPPPPPPPPPPPPPPPPPQAAAAAAAAAAWGGGGGGGGGGGGGG
GGGGGGGGGGGGGGGGGGCXPPPPPPPPPPPPPPPPPPPPPPPPPPPPPPPQAAAAAAAAAAWGGGGGGGGGGGGGG
GGGGGGGGGGGGGGGGGGCXPPPPPPPPPPPPPPPPPPPPPPPPPPPPPPPQAAAAAAAAAAWGGGGGGGGGGGGGG
GGGGGGGGGGGGGGGGGGCXPPPPPPPPPPPPPPPPPPPPPPPPPPPPPPPMNMNMNMNMNMNGGGGGGGGGGGGGG
GGGGGGGGGGGGGGGGGGCXPPPPPPPPPPPPPPPPPPPPPPPPPPPPPPPMNMNMNMNMNMNGGGGGGGGGGGGGG
GGGGGGGGGGGGGGGGGGCXPPPPPPPPPPPPPPPPPPPPPPPPPPPPPPPSYYYYYYYYYYUGGGGGGGGGGGGGG
GGGGGGGGGGGGGGGGGGCXPPPPPPPPPPPPPPPPPPPPPPPPPPPPPPPQAAAAAAAAAAWGGGGGGGGGGGGGG
GGGGGGGGGGGGGGGGGGCXPPPPPPPPPPPPPPPPPPPPPPPPPPPPPPPQAAAAAAAAAAWGGGGGGGGGGGGGG
GGGGGGGGGGGGGGGGGGCXPPPPPPPPPPPPPPPPPPPPPPPPPPPPPPPQAAAAAAAAAAWGGGGGGGGGGGGGG
GGGGGGGGGGGGGGGGGGCXPPPPPPPPPPPPPPPPPPPPPPPPPPPPPPPQAAAAAAAAAAWGGGGGGGGGGGGGG
GGGGGGGGGGGGGGGGGGCXPPPPPPPPPPPPPPPPPPPPPPPPPPPPPPPQAAAAAAAAAAWGGGGGGGGGGGGGG
GGGGGGGGGGGGGGGGGGCXPPPPPPPPPPPPPPPPPPPPPPPPPPPPPPPQAAAAAAAAAAWGGGGGGGGGGGGGG
GGGGGGGGGGGGGGGGGGC9LLLLLLLLLLLLLLLLLLLLLLLLLLLLLLLDAAAAAAAAAAWGGGGGGGGGGGGGG
GGGGGGGGGGGGGGGGGGGZZZZZZZZZZZZZZZZZZZZZZZZZZZZZZZZIAAAAAAAAAAWGGGGGGGGGGGGGG
GGGGGGGGGGGGGGGGGGGGGGGGGGGGGGGGGGGGGGGGGGGGGGGGGGGIAAAAAAAAAAWGGGGGGGGGGGGGG
GGGGGGGGGGGGGGGGGGGGGGGGGGGGGGGGGGGGGGGGGGGGGGGGGGGIAAAAAAAAAAWGGGGGGGGGGGGGG
GGGGGGGGGGGGGGGGGGGGGGGGGGGGGGGGGGGGGGGGGGGGGGGGGGGIAAAAAAAAAAWGGGGGGGGGGGGGG
GGGGGGGGGGGGGGGGGGGGGGGGGGGGGGGGGGGGGGGGGGGGGGGGGGGIAAAAAAAAAAKEEEEEEEEEEEEEE
GGGGGGGGGGGGGGGGGGGGGGGGGGGGGGGGGGGGGGGGGGGGGGGGGGGIAAAAAAAAAAAAAAAAAAAAAAAAA
GGGGGGGGGGGGGGGGGGGGGGGGGGGGGGGGGGGGGGGGGGGGGGGGGGGIAAAAAAAAAAAAAAAAAAAAAAAAA
GGGGGGGGGGGGGGGGGGGGGGGGGGGGGGGGGGGGGGGGGGGGGGGGGGGIAAAAAAAAAAAAAAAAAAAAAAAAA
GGGGGGGGGGGGGGGGGGGGGGGGGGGGGGGGGGGGGGGGGGGGGGGGGGGIAAAAAAAAAAAAAAAAAAAAAAAAA
GGGGGGGGGGGGGGGGGGGGGGGGGGGGGGGGGGGGGGGGGGGGGGGGGGGIAAAAAAAAAAAAAAAAAAAAAAAAA
